e,e,e,e,e,e,e,e,e,e,e,e,e,e,e,e,e,e
e,f,f,f,f,f,f,e,e,f,f,f,f,f,f,f,f,e
e,f,w,w,w,w,f,e,e,f,w,w,w,w,w,w,f,e
e,f,w,w,w,w,f,e,e,f,w,w,w,w,w,w,f,e
e,f,w,w,w,w,f,e,e,f,w,w,w,w,w,w,f,e
e,f,w,w,w,w,f,e,e,f,w,w,w,w,w,w,f,e
e,f,w,w,w,w,f,e,e,f,w,w,w,w,w,w,f,e
e,f,f,f,f,f,f,e,e,f,f,f,f,f,f,f,f,e
e,e,e,e,e,e,e,e,e,e,e,e,e,e,e,e,e,e
